RRRRRRRRRRRRRRRRRRRRRRRRRRRRRRRRRR
R                                R
R                                R
R                   G  RRRRRR    R
R                   G  RPPPPR    R
R                   G  RRRRRR    R
R                                R
R                                R
R                                R
R                                R
R                                R
R                                R
R                                R
R                                R
R                                R
R                                R
