RRRRRRRRRRRRRRRRRRRRRRRRRRRRRRRRRR
RPPPPPPPPPPPPPPPPPPPPPPPPPPPPPPPPR
R                                R
R                                R
R                                R
RPPPPPPPPPPPPPPPPPPPPPPPPPPPPPPPPR
R                                R
R                                R
R                                R
RPPPPPPPPPPPPPPPPPPPPPPPPPPPPPPPPR
R                                R
R                                R
R                                R
RPPPPPPPPPPPPPPPPPPPPPPPPPPPPPPPPR
R                                R
R                                R
