RRRRRRRRRRRRRRRRRRRRRRRRRRRRRRRRRR
R                                R
R                                R
R                   G  WWW       R
R                   G  WPW       R
R                   G  RRR       R
R                                R
R                    WWW         R
R                    W           R
R                    W PPPPPPP   R
R                    WWWWWWWWW   R
R                                R
R                                R
R                                R
R                                R
R                   PPPPPPPPPP   R
